########################################
#...........#######....................#
#...#........................#.........#
#.....................#................#
#.....##.......#.......................#
#.....................#................#
#......................................#
#......#.......##.......#.........#....#
#......................................#
#......................................#
#...#..........##............#.........#
#...#..................................#
#...#................###.#.............#
#...#...........................#......#
#.........#.....................#......#
#..................@......#.....#......#
#...#..................................#
#......................................#
#..............##............#.........#
#...#........................#.........#
#............................#.........#
#.......##...................#.........#
#................###.........#.........#
#......................................#
#......................................#
#....####............######............#
#....................#....#............#
#....................##................#
#.....................##........#.#....#
#.....#..............###...............#
#.................#######..............#
########..###################..#########
#...............................##.....#
#..................##...........##.....#
#.....#######.......#...........##.....#
#.....#.....#.......#..................#
#.....#.....#..........####..........###
#...........#...................#......#
#...........#...................#......#
########################################
